Q=q
W=w
E=e
R=r
T=t
Y=y
U=u
I=i
O=o
P=p
A=a
S=s
D=d
F=f
G=g
H=h
J=j
K=k
L=l
Z=z
X=x
C=c
V=v
B=b
N=n
M=m
É=é
Ö=ö
Ó=ó
Ê=ê
Å=å
Í=í
Ã=ã
Ø=ø
Ù=ù
Ç=ç
Õ=õ
Ú=ú
Ô=ô
Û=û
Â=â
À=à
Ï=ï
Ð=ð
Î=î
Ë=ë
Ä=ä
Æ=æ
Ý=ý
ß=ÿ
×=÷
Ñ=ñ
Ì=ì
È=è
Ò=ò
Ü=ü
Á=á
Þ=þ
¨=¸