À=A
Á=B
Â=V
Ã=G
Ä=D
Å=E
¨=E
Æ=J
Ç=Z
È=I
É=I
Ê=K
Ë=L
Ì=M
Í=N
Î=O
Ï=P
Ð=R
Ñ=S
Ò=T
Ó=U
Ô=F
Õ=H
Ö=C
×=Ch
Ø=Sh
Ù=Sch
Û=Y
Ý=E
Þ=Yu
ß=Ya
à=a
á=b
â=v
ã=g
ä=d
å=e
¸=e
æ=j
ç=z
è=i
é=i
ê=k
ë=l
ì=m
í=n
î=o
ï=p
ð=r
ñ=s
ò=t
ó=u
ô=f
õ=h
ö=c
÷=ch
ø=sh
ù=sch
û=y
ý=e
þ=yu
ÿ=ya